+---+---+---+---+---+---+---+---+
  S                             |
+   +---+---+---+---+---+---+   +
|   |                           |
+   +   +---+---+---+---+---+---+
|                               |
+---+---+   +---+   +---+   +---+
|           |       |         G  
+   +---+---+---+---+   +---+---+
