+---+---+---+---+---+
    |               |
+   +   +   +---+---+
|   |   |           |
+   +---+---+---+   +
|   |               |
+   +   +---+---+   +
|       |           |
+---+---+   +---+---+
|                  	   
+---+---+---+---+---+
